..............................
.                            .
.                      #     .
.   #                 ###    .
.  ###               #####   .
. #####                #     .
.   #        #         #     .
.   #       ###              .
.          #####             .
.#           #               .
.###         #               .
.#                         ##.
.     #                  ####.
.    ###                #####.
.   #####                ####.
.     #                    ##.
.     #                     #.
.   ######################  #.
.                            .
.                  #         .
.     #           ###        .
.    ###         #####       .
.   #####          #         .
.     #            #         .
.     #                      .
.                            .
.                            .
.                     #      .
.                    #####   .
..............................